0 0 0 0 0 0 0 0 0 0 0 0 0 0 0 0 0 0 0
0 1 1 1 1 1 1 1 1 1 1 1 1 1 0 1 1 1 0
0 1 0 0 0 0 0 0 0 0 0 0 0 1 0 1 0 1 0
0 1 0 1 1 1 1 1 1 1 1 1 1 1 0 1 0 1 0
0 1 0 1 0 0 0 0 0 0 0 0 0 0 0 1 0 1 0
0 1 0 1 0 1 1 1 1 1 1 1 1 1 0 1 0 1 0
0 1 0 1 0 1 0 0 0 0 0 0 0 0 0 1 0 1 0
0 1 0 1 0 1 0 1 1 1 1 1 1 1 0 1 0 1 0
0 1 0 1 0 1 0 0 0 0 0 0 0 1 0 1 0 1 0
0 1 0 1 0 1 0 1 1 1 1 1 1 1 0 1 0 1 0
0 1 0 1 0 1 0 1 0 0 0 0 0 0 0 1 0 1 0
0 1 0 1 0 1 0 1 0 1 1 1 1 1 1 1 1 1 0
0 1 0 1 0 1 0 1 0 1 0 0 0 0 0 1 0 0 0
0 1 0 1 0 1 1 1 0 1 0 1 1 1 1 1 0 1 1
0 1 0 1 0 0 0 0 0 1 0 1 0 0 0 0 0 1 0
0 1 1 1 0 1 1 1 0 1 0 1 0 0 0 0 0 1 0
0 0 0 0 0 1 0 1 0 1 0 1 0 0 0 0 0 1 0
0 1 1 1 1 1 0 1 0 1 1 1 0 1 1 1 1 1 0
0 0 0 0 0 0 0 1 0 0 0 0 0 0 0 0 0 0 0
end
2
0
99
This is a maze file